 _ _ _ _ _ _ _ _ _ _ _ _ _ _ _ _ 
|                               |
|                               |
|                               |
|                               |
|                               |
|                               |
|                               |
|                               |
|                               |
|                               |
|                               |
|                               |
|                               |
|                               |
|                               |
|_ _ _ _ _ _ _ _ _ _ _ _ _ _ _ _|
360
